Atelopuslimosus-inhibitory_48	TACGTAGGGTACGAGCGTTGTCCGGAATTATTGGGCGTAAAGAGCTCGTAGGTGGTTGGTCACGTCTGCTGTGGAAACGCAACGCTTAAC
Ranamuscosa-inhibitory_35	TACGTAGGGTGCGAGCGTTAATCGGAATTACTGGGCGTAAAGCGTGCGCAGGCGGTTATGTAAGACAGATGTGAAATCCCCGGGCTCAAC
Alytesobstetricans-inhibitory_34	TACGGAGGGTGCAAGCGTTAATCGGAATTACTGGGCGTAAAGCGCACGCAGGCGGTTGGATAAGTTAGATGTGAAAGCCCCGGGCTCAAC
Dendrobatesauratus-inhibitory_13	TACGAAGGGTGCAAGCGTTACTCGGAATTACTGGGCGTAAAGCGTGCGTAGGTGGTTTGTTAAGTCTGATGTGAAAGCCCTGGGCTCAAC
Atelopuslimosus-inhibitory_28	TACAGAGGGTGCGAGCGTTAATCGGATTTACTGGGCGTAAAGCGTGCGTAGGCGGCTTTTTAAGTCGGATGTGAAATCCCCGAGCTTAAC
Atelopuslimosus-inhibitory_45	TACGAAGGGGGCTAGCGTTGTTCGGAATTACTGGGCGTAAAGCGCACGTAGGCGGATATTTAAGTCAGGGGTGAAATCCCAGAGCTCAAC
Espadaranaprosoblepon-inhibitory_40	TACAGAGGGTGCAAGCGTTAATCGGAATTACTGGGCGTAAAGCGCGCGTAGGTGGTTCGTTAAGTTGGATGTGAAAGCCCCGGGCTCAAC
Mantidactylusbetsileanus-inhibitory_2	TACGAAGGGGGCTAGCGTTGCTCGGAATTACTGGGCGTAAAGGGAGCGTAGGCGGACATTTAAGTCAGGGGTGAAATCCCGGGGCTCAAC
Silverstoneiaflotator-inhibitory_16	TACGAAGGGGGCTAGCGTTGCTCGGAATTACTGGGCGTAAAGGGCGCGTAGGCGGATCGTTAAGTCAGAGGTGAAATCCCGGAGCTCAAC
Litorianannotis-inhibitory_24	TACGGAGGATCCGAGCGTTATCCGGATTTATTGGGTTTAAAGGGTGCGTAGGCGGCCTATTAAGTCAGGGGTGAAATACGGTGGCTCAAC
Alytesobstetricans-inhibitory_18	TACAGAGGGTGCGAGCGTTAATCGGATTTACTGGGCGTAAAGCGTGCGTAGGCGGCTTTTTAAGTCGGATGTGAAATCCCTGAGCTTAAC
Atelopuslimosus-inhibitory_69	TACGGAGGGTGCAAGCGTTATCCGGATTTATTGGGTTTAAAGGGTCCGTAGGCGGATCTGTAAGTCAGTGGTGAAATCTCACAGCTTAAC
Boophismadagascariensis-inhibitory_6	TACGAAGGGGGCTAGCGTTGTTCGGAATTACTGGGCGTAAAGCGCACGTAGGCGGATATTTAAGTCAGGGGTGAAATCCCGCAGCTCAAC
Ranamuscosa-inhibitory_37	TACGTAGGGTGCAAGCGTTAATCGGAATTACTGGGCGTAAAGCGTGCGCAGGCGGCTTTGTAAGACAGATGTGAAATCCCCGGGCTCAAC
Hyalinobatrachiumcolymbiphyllum-inhibitory_17	TACGAAGGGTGCAAGCGTTAATCGGAATTACTGGGCGTAAAGCGCGCGTAGGTGGTTCAGCAAGTTGGATGTGAAAGCCCCGGGCTCAAC
Alytesobstetricans-inhibitory_79	TACAGAGGGTGCAAGCGTTAATCGGAATTACTGGGCGTAAAGCGCGCGTAGGTGGTTCGTTAAGTTGGATGTGAAATCCCCGGGCTCAAC
Ranasphenocephala-inhibitory_4	TACGGAGGGAGCTAGCGTTATTCGGAATTACTGGGCGTAAAGCGCACGTAGGCGGCTTTGTAAGTTAGAGGTGAAAGCCTGGAGCTCAAC
Atelopuslimosus-inhibitory_29	TACGTAGGGCGCAAGCGTTATCCGGAATTATTGGGCGTAAAGAGCTCGTAGGCGGTTTGTCGCGTCTGCTGTGAAATCCCGAGGCTCAAC
Alytesobstetricans-inhibitory_22	TACGTAGGGTGCAAGCGTTAATCGGAATTACTGGGCGTAAAGCGTGCGCAGGCGGTTTTGTAAGACAGTGGTGAAATCCCCGGGCTCAAC
Atelopuslimosus-inhibitory_62	TACGGAGGGTGCAAGCGTTATCCGGATTCACTGGGTTTAAAGGGTGCGTAGGTGGGTTAGTAAGTCAGTGGTGAAATCTTCGAGCTTAAC
Allobatestalamancae-inhibitory_3	TACGAAGGGTGCAAGCGTTAATCGGAATTACTGGGCGTAAAGCGCGCGTAGGTGGTTCAGCAAGTTGGAGGTGAAATCCCCGGGCTCAAC
Colostethuspanamensis-inhibitory_1	TACGAAGGGTGCAAGCGTTAATCGGAATTACTGGGCGTAAAGCGCGCGTAGGTGGTTCAGCAAGTTGAAGGTGAAATCCCCGGGCTCAAC
Boophismadagascariensis-inhibitory_1	TACAGAGGGTGCAAGCGTTAATCGGATTTACTGGGCGTAAAGCGCGCGTAGGCGGCTAATTAAGTCAAATGTGAAATCCCCGAGCTTAAC
Craugastorcrassidigitus-inhibitory_165	TACGGAGGGTGCAAGCGTTATCCGGATTTATTGGGTTTAAAGGGTCCGTAGGCGGATTAATCAGTCAGTGGTGAAATCCCGCAGCTTAAC
Silverstoneiaflotator-inhibitory_39	TACGTAGGGTGCAAGCGTTAATCGGAATTACTGGGCGTAAAGCGTGCGCAGGCGGTTATGCAAGACAGATGTGAAATCCCCGGGCTCAAC
Alytesobstetricans-inhibitory_14	TACGGAGGATCCAAGCGTTATCCGGAATCATTGGGTTTAAAGGGTCCGTAGGCGGTTTAGTAAGTCAGTGGTGAAAGCCCATCGCTCAAC
Smiliscasordida-inhibitory_4	TACGTAGGGTGCAAGCGTTAATCGGAATTACTGGGCGTAAAGCGTGCGCAGGCGGTTTTATAAGTCTGATGTGAAATCCCCGGGCTCAAC
Boophismadagascariensis-inhibitory_4	TACAGAGGGTGCAAGCGTTAATCGGAATTACTGGGCGTAAAGCGCGCGTAGGTGGTTTGTTAAGTTGAATGTGAAATCCCCGGGCTCAAC
Atelopusaff.limosus-inhibitory_15	TACGGAGGGTGCAAGCGTTATCCGGATTTATTGGGTTTAAAGGGTCCGTAGGCGGACTGATAAGTCAGTGGTGAAATCCGACAGCTTAAC
Smiliscasila-inhibitory_3	TACGTAGGGTGCGAGCGTTATCCGGAATTATTGGGCGTAAAGAGCTCGTAGGCGGTTTGTCGCGTCTGTCGTGAAAGTCCGGGGCTTAAC
Atelopusaff.limosus-inhibitory_19	TACAGAGGGTGCAAGCGTTAATCGGAATTACTGGGCGTAAAGCGCGCGTAGGTGGTTAGTTAAGTTGGATGTGAAATCCCCGGGCTCAAC
Atelopuselegans-inhibitory_1	TACGAAGGGTGCAAGCGTTAATCGGAATTACTGGGCGTAAAGCGCGCGTAGGTGGTTCAGCAAGTTGGATGTGAAATCCCCGGGCTCAAC
Atelopuslimosus-inhibitory_22	TACGGAGGGTGCAAGCGTTAATCGGAATTACTGGGCGTAAAGCGCACGCAGGCGGTCTGTCAAGTCGGATGTGAAATCCCCGGGCTTAAC
Alytesobstetricans-inhibitory_55	TACGGAGGATCCAAGCGTTATCCGGAATCATTGGGTTTAAAGGGTCCGTAGGCGGTTTAATAAGTCAGTGGTGAAAGCCCATCGCTCAAC
Dendrobatesauratus-inhibitory_9	TACGAAGGGTGCAAGCGTTACTCGGAATTACTGGGCGTAAAGCGTGCGTAGGTGGTTATTTAAGTCCGTTGTGAAAGCCCTGGGCTCAAC
Hemidactylumscutatum-inhibitory_20	TACGTAGGGTGCAAGCGTTAATCGGAATTACTGGGCGTAAAGCGTGCGCAGGCGGTGATGTAAGACAGTTGTGAAATCCCCGGGCTCAAC
Hemidactylumscutatum-inhibitory_16	TACGTAGGGCGCAAGCGTTATCCGGAATTATTGGGCGTAAAGAGCTCGTAGGCGGTTTGTCGCGTCTGCTGTGAAAGACCGGGGCTCAAC
Litoriarheocola-inhibitory_25	TACGGAGGGAGCTAGCGTTGTTCGGAATTACTGGGCGTAAAGCGCGCGTAGGCGGTTACTCAAGTCAGAGGTGAAAGCCCGGGGCTCAAC
Dendrobatesauratus-inhibitory_16	TACGAAGGGGGCTAGCGTTGTTCGGATTTACTGGGCGTAAAGCGCACGTAGGCGGATCGATCAGTCAGGGGTGAAATCCCAGGGCTCAAC
Anaxyrusboreas-inhibitory_4	TACGGAGGGTGCAAGCGTTAATCGGAATTACTGGGCGTAAAGCGCACGCAGGCGGTTTGTTAAGTCAGATGTGAAATCCCCGGGCTCAAC
Atelopuslimosus-inhibitory_26	TACGAAGGGGGCTAGCGTTGTTCGGATTTACTGGGCGTAAAGCGCACGTAGGCGGATCGATCAGTCAGGGGTGAAATCCCAGAGCTCAAC
Atelopusspurrelli-inhibitory_1	TACGGAGGGTGCAAGCGTTATCCGGATTTATTGGGTTTAAAGGGTCCGTAGGCGGACTAGTAAGTCAGTGGTGAAATCCGACAGCTTAAC
Atelopuslimosus-inhibitory_37	TACGTAGGGTGCAAGCGTTAATCGGAATTACTGGGCGTAAAGCGTGCGCAGGCGGTGATGCAAGACCGATGTGAAATCCCCGGGCTCAAC
Alytesobstetricans-inhibitory_5	TACAGAGGGTGCAAGCGTTAATCGGAATTACTGGGCGTAAAGCGCGCGTAGGTGGTTTGTTAAGTTGGATGTGAAATCCCCGGGCTCAAC
Smiliscasordida-inhibitory_11	TACGAAGGGGGCTAGCGTTGCTCGGAATTACTGGGCGTAAAGGGAGCGTAGGCGGACATTTAAGTCAGGGGTGAAATCCCGGAGCTCAAC
Boophismadagascariensis-inhibitory_5	TACGTAGGGTGCGAGCGTTAATCGGAATTACTGGGCGTAAAGCGTGCGCAGGCGGTTATGTAAGACAGTTGTGAAATCCCCGGGCTCAAC
Ranamuscosa-inhibitory_74	TACGTAGGGTGCAAGCGTTAATCGGAATTACTGGGCGTAAAGCGTGCGCAGGCGGTTTTGTAAGTCTGATGTGAAATCCCCGGGCTCAAC
Smiliscasordida-inhibitory_30	TACGAAGGGTGCAAGCGTTAATCGGAATTACTGGGCGTAAAGCGCGCGTAGGTGGCTTGATAAGTTGGATGTGAAATCCCCGGGCTCAAC
Atelopuslimosus-inhibitory_70	TACGTAGGTCCCGAGCGTTGTCCGGATTTATTGGGCGTAAAGCGAGCGCAGGTGGTTTATTAAGTCTGGTGTAAAAGGCAGTGGCTCAAC
Atelopuslimosus-inhibitory_64	TACGGAGGGTGCAAGCGTTATCCGGATTTATTGGGTTTAAAGGGTCCGTAGGCTGATCTGTAAGTCAGTGGTGAAATCTCACAGCTTAAC
Ranasphenocephala-inhibitory_5	TACAGAGGGTGCAAGCGTTAATCGGAATTACTGGGCGTAAAGGGAGCGTAGGCGGACATTTAAGTCAGGGGTGAAATCCCGGGGCTCAAC
Strabomantisbufoniformis-inhibitory_14	TACGTAGGGTGCGAGCGTTAATCGGAATTACTGGGCGTAAAGGGTGCGCAGGTGGTTACGTAAGTCTGATGTGAAAGCCCCGGGCTCAAC
Strabomantisbufoniformis-inhibitory_6	TACGTAGGGTCCAAGCGTTAATCGGAATTACTGGGCGTAAAGCGTGCGCAGGCGGTTGTGCAAGACCGATGTGAAATCCCCGAGCTTAAC
Bufotyphonius-inhibitory_17	TACAGAGGGTGCGAGCGTTAATCGGATTTACTGGGCGTAAAGCGTGCGTAGGCGGCTTATTAAGTCGGATGTGAAATCCCCGAGCTTAAC
Bufotyphonius-inhibitory_23	TACGTAGGTGGCAAGCGTTATCCGGAATTATTGGGCGTAAAGCGCGCGCAGGTGGTTTCTTAAGTCTGATGTGAAAGCCCACGGCTCAAC
Litorianannotis-inhibitory_1	TACGAAGGGTGCAAGCGTTACTCGGAATTACTGGGCGTAAAGCGTGCGTAGGTGGTTGTTTAAGTCCGTTGTGAAAGCCCTGGGCTCAAC
Craugastorcrassidigitus-inhibitory_87	TACGGAGGATCCAAGCGTTATCCGGAATCATTGGGTTTAAAGGGTCCGTAGGCGGTCTTGTAAGTCAGTGGTGAAAGCCCATCGCTCAAC
Ranasphenocephala-inhibitory_15	GTAGACCGCCTGGGGAGTACGGTCGCAAGACTAAAACTCAAATGAATTGACGGGGGCCCGCACAAGCGGTGGAGCATGTGGTTTAATTCG
Atelopuslimosus-inhibitory_65	TACGGAGGGTGCAAGCGTTAATCGGAATTACTGGGCGTAAAGCGTGCGTAGGCGGTTCGTTAAGTCTGCTGTGAAAGCCCCGGGCTCAAC
Litoriaserrata-inhibitory_39	TACGGAGGGTGCAAGCGTTAATCGGAATTACTGGGCGTAAAGCGTGTGTAGGCGGTTTGTTAAGTCTGTTGTGAAAGCCCCGGGCTCAAC
Hemidactylumscutatum-inhibitory_18	TACGTAGGGTGCAAGCGTTAATCGGAATTACTGGGCGTAAAGCGTGCGCAGGCGGTTTTGTAAGTCTGTCGTGAAATCCCCGGGCTCAAC
Litorianannotis-inhibitory_49	TACGTAGGGTCCAAGCGTTAATCGGAATTACTGGGCGTAAAGGGTGCGCAGGTGGTTGATTAAGTGTGATGTGAAAGCCCCGGGCTCAAC
Ranamuscosa-inhibitory_72	TACGTAGGTGGCAAGCGTTGTCCGGAATTATTGGGCGTAAAGGGCTCGCAGGCGGTTTCTTAAGTCTGATGTGAAAGCCCCCGGCTCAAC
Lithobatescatesbeianus-inhibitory_20	TACGTAGGGTGCGAGCGTTAATCGGAATTACTGGGTGTAAAGAGCTCGTAGGCGGTTTGTCGCGTCTGCTGTGAAATCCCGAGGCTCAAC
Mantidactylusbetsileanus-inhibitory_1	TACGTAGGTGGCAAGCGTTGTCCGGAATTATTGGGCGTAAAGCGCGCGCAGGCGGTCTTTTAAGTCTGATGTGAAAGCCCCCGGCTCAAC
Craugastorcrassidigitus-inhibitory_4	CCGTCCTCCCGAAGGTTAGACTAGCTACTTCTGGTGCAACCCACTCCCATGGTGTGACGGGCGGTGTGTACAAGGCCCGGGAACGTATTC
Lithobatescatesbeianus-inhibitory_44	AATGCATAGATATTACTTAGAACACCAATTGCGAAGGCAGGTTACTAAGCAACAACTGACGCTGATGGACGAAAGCGTGGGGAGCGAACA
Mantidactylusbetsileanus-inhibitory_6	TACGGAGGGTGCAAGCGTTATCCGGATTTATTGGGTTTAAAGGGTCCGTAGGCTGATGTGTAAGTCAGTGGTGAAATCTCACAGCTTAAC
Mantidactylusbetsileanus-inhibitory_14	TACGTAGGGCGCAAGCGTTGTCCGGAATTATTGGGCGTAAAGAGCTCGTAGGCGGCTTGTCACGTCGGATGTGAAAGCCCGGGGCTTAAC
Alytesobstetricans-inhibitory_27	TACGGAGGGTGCAAGCGTTAATCGGAATTACTGGGCGTAAAGCGCACGCAGGCGGTTTGTTAAGTCAGATGTGAAATCCCCGCGCTTAAC
Ranasphenocephala-inhibitory_20	TACAGAGGGTGCAAGCGTTAATCGGATTTACTGGCGTAAAGCGCGCGTAGGCGGCTAATTAAGTCAAATGTGAAATCCCCGAGCTTAACT
Dendrobatesauratus-inhibitory_8	AATGCGTAGAGATCTGGAGGAATACCGGTGGCGAAGGCGGCCCCCTGGACAAAGACTGACGCTCAGGTGCGAAAGCGTGGGGAGCAAACA
Hyalinobatrachiumcolymbiphyllum-inhibitory_28	GCGCCCTCCTTGCGGTTAGGCTACCTACTTCTGGCGAGACCCGCTCCCATGGTGTGACGGGCGGTGTGTACAAGACCCGGGAACGTATTC
Mantidactylusbetsileanus-inhibitory_5	TACGTAGGTGGCAAGCGTTGTCCGGAATTATTGGGCGTAAAGCGCGCGCAGGTGGTTCCTTAAGTCTGATGTGAAAGCCCACGGCTCAAC
Agalychniscallidryas-inhibitory_13	TCGCCCTCCTTGCGGTTAGGCTAACTACTTCTGGCAGAACCCGCTCCCATGGTGTGACGGGCGGTGTGTACAAGACCCGGGAACGTATTC
Atelopuslimosus-inhibitory_46	GCCGTTACCCTACCAACTAGCTAATGTCACGCGAGCCCATCTCTATCCTATAAATATTTAATATCCAACTGATGCCAATCAGATATATTA
Craugastorcrassidigitus-inhibitory_111	TACGTAGGGTGCAAGCGTTAATCGGAATTACTGGGCGTAAAGCGTGCGCAGGCGGTTGTGCAAGTCTGATGTGAAAGCCCCGGGCTTAAC
Lithobatescatesbeianus-inhibitory_36	AATGCGTAGATATAGGAAGGAACACCAGTGGCGAAGGCGACCACCTGGGCTCATACTGACACTGAGGTGCGAAAGCGTGGGGAGCAAACA
Craugastorcrassidigitus-inhibitory_98	GCGCCCTCCTTGCGGTTAGGCTACCTGCTTCTGGCGAGACCCGCTCCCATGGTGTGACGGGCGGTGTGTACAAGACCCGGGAACGTATTC
Ranasphenocephala-inhibitory_6	TACGAAGGGTGCCCGCGTTCCTCGGCCTTCCTGGGCGTAAAGCGTGCGTAGGTGGTCGTTTAAGTCCGTTGTGAAAGCCCTGGGCTCAAC
Espadaranaprosoblepon-inhibitory_21	GGACGACGGCCCTATGGGTTGTAAACTTCTTTTGTATAGGGATAAACCTTTCCACGTGTGGAAAGCTGAAGGTACTATACGAATAAGCAC
Strabomantisbufoniformis-inhibitory_2	GATATTCGGAGGAACACCAGTGGCGAAGGCGGCTTACTGGTCCATTACTGACGCTGAGGTGCGAAAGCGTGGGGAGCAAACAGGATTAGA
Atelopuslimosus-inhibitory_63	GGGAGATTGGAATTCCTGGTGTAGCGGTGGAATGCGCAGATATCAGGAGGAACACCGATGGCGAAGGCAGATCTCTGGGCCGTAACTGAC
Litorianannotis-inhibitory_25	GCCAATCCCAGAAACCCTATCTCAGTCCGGATTGGAGTCTGCAACTCGACTCCATGAAGTCGGAATCGCTAGTAATCGCAGATCAGCATT
Allobatestalamancae-inhibitory_8	TACGTAGGGGGCAAGCGTTGTCCGGAATTATTGGGCGTAAAGCGCGCGCAGGCGGTCATTTAAGTCTGGTGTTTAATCCCGGGGCTCAAC
Atelopusaff.limosus-inhibitory_11	TATGAAACTGCCATTGATACTGCAGGTCTTGAGTAAGGTAGAAGTGGCTGGAATAAGTAGTGTAGCGGTGAAATGCATAGATATTACTTA
Litoriarheocola-inhibitory_7	TACGAAGGGTGCCCGCGTTCCTCGGCCTTCCTGGGCGTAAAGCGTGCGTAGGTGGTTGTTTAAGTCTGTTGTGAAAGCCCTGGGCTCAAC
Ranamuscosa-inhibitory_14	TACAGAGGGTGCAAGCGTTAATCGGAATTACTGGGCGTAAAGCGCGCGTAGTGGTTCGTTAAGTTGGATGTGAAATCCCCGGGCTCAACC
Espadaranaprosoblepon-inhibitory_14	TGAAAGCCCCGGGCTCAACCTGGGAACTGCATCCAAAACTGGCGAGCTAGAGTAGGGCAGAGGGTGGTGGAATTTCCTGTGTAGCGGTGA
Craugastorcrassidigitus-inhibitory_84	CCGTCCCCCTTGCGGTTAGACTAGCTACTTCTGGAGCAACCCACTCCCATGGTGTGACGGGCGGTGTGTACAAGGCCCGGGAACGTATTC
Ranasphenocephala-inhibitory_25	TACGGAGGGTGCAAGCGTTATCCGGATTCACTGGGTTTAAAGGGTGCGTAGGTGGTCGTTTAAGTCCGTTGTGAAAGCCCTGGGCTCAAC
Ranasphenocephala-inhibitory_26	GACGAGGGATCCTAGCGTTGTTCGGAATCATTGGGCGTAAAGCGGGTGTAGGCGGCTAATTAAGTCAAATGTGAAATCCCCGAGCTTAAC
Litoriaserrata-inhibitory_7	TACGTAGGGTGCAAGCGTTAATCGGAATTACTGGGCGTAAAGCGTGCGCAGGCGGTTCGGAAGAAAGATGTGAAATCCCAGGGCTCAACC
